000000111000000
000000000000000
000000000000000
000000000000000
000000000100000
000000111100001
000000000000001
000000000000001
000000000000000
000100000000000
111100000000000
000000000000000
000000001100000
000000001100000
000000001100011
111100000000000
000100000000000
000000000000000
000000000000000
000000010000000